NO ./textures/NO.png
SO ./textures/SO.png
WE ./textures/WE.png
EA ./textures/EA.png

F 220,100,0
C 225,30,0

111111111111
1N0000000001
111011111101
100010000001
101110111101
100000100001
111111111111
