NO ./textures/NO.png
SO ./textures/SO.png
WE ./textures/WE.png
EA ./textures/EA.png

F 90,90,90
C 170,170,190

1111111111111111111111111111111111111111
1000000000000000000000000000000000000001
1000000000000000000000000000000000000001
1000000000000000000000000000000000000001
1000000000011111111110000000000000000001
1000000000000000000000000000000000000001
1000000000000000000011110000000000000001
1000000000000000000000000000000000000001
1000000000000000000N00000000000000000001
1000000000000000000000000000000000000001
1000000000000001111111111000000000000001
1000000000000000000000000000000000000001
1000000011110000000000000000001111000001
1000000000000000000000000000000000000001
1000000000000000000000000000000000000001
1000000000000000000000000000000000000001
1000000000000000000000000000000000000001
1111111111111111111111111111111111111111
