NO ./textures/NO.png
SO ./textures/SO.png
WE ./textures/WE.png
EA ./textures/EA.png

F 0,255,0
C 0,0,255

11111111    
100100011111
101000000001
1000N1111111
101100000001
11  11111111