NO ./textures/NO.png
SO ./textures/SO.png
WE ./textures/WE.png
EA ./textures/EA.png

F 80,80,80
C 170,170,200

111111111111111
1N0000010000001
101111101011101
100000101000101
111110101110101
100010100010101
101010111010101
101010001010001
101011101011101
100000001000001
111111111111111
