NO ./textures/NO.png
SO ./textures/SO.png
WE ./textures/WE.png
EA ./textures/EA.png

F 220,100,0
C 225,30,0

111111
1W0101
101001
1100N1
111111